00000XXXXXX000
0SXXXX0000X000
00X00XXXX0XXXR
00XXX000XXXX0X
0XX0XXXXX00X0X
0XXX0X00X00X0X
0X0XXX00000XXX
0L000000000XE0