00000XXXXXX000
0SXXXX0000X000
00X00XXXX0XXXG
00XXX000XXXX0X
TXX0XXXXX00X0X
0XXX0X00L00X0X
0X0XXF00000XXX
0C000000000XE0